20
mouse
###P###
#######
###W###
##WWW##
###W###
#######
M#####C